6 6 7 8 6 6 6 6 6 6 6 6 6 6 6 6 6 6 6 6 6 6 6 6 6 6 6 6 6 6 6 6 6 6 6 6 6 6 6 6 6 6 6 6 6 6 6 6 6 6
6 3 3 3 1 3 3 3 1 3 3 3 3 3 3 3 3 3 3 3 3 3 1 3 3 3 1 3 3 3 3 1 3 3 3 3 3 3 3 3 3 3 3 3 3 3 3 3 3 6
6 3 3 3 1 3 1 3 1 3 3 3 1 1 1 1 3 3 1 1 1 3 1 3 3 3 3 3 1 1 3 1 3 3 3 4 4 4 4 4 4 4 4 3 3 3 3 3 3 6
6 3 3 3 1 1 1 3 1 3 3 3 1 3 3 3 3 3 3 3 1 3 1 1 1 3 1 3 3 1 3 1 3 3 4 4 4 4 4 4 4 4 4 4 4 4 3 3 3 6
6 3 3 3 3 3 1 3 1 3 1 1 1 1 3 1 1 1 1 3 1 3 3 3 3 3 1 3 3 1 3 1 3 3 4 4 4 4 4 4 5 4 4 4 4 4 4 3 3 6
6 1 1 1 1 3 1 3 1 3 3 3 3 3 3 1 3 3 3 3 1 3 1 1 1 1 1 3 3 1 3 1 3 3 4 4 4 4 4 4 4 5 5 4 4 4 4 3 3 6
6 3 3 3 3 3 3 3 1 3 3 3 3 3 3 1 1 1 1 3 1 3 3 3 3 3 3 3 3 1 3 1 3 3 4 4 4 4 5 4 4 4 5 4 4 4 4 4 3 6
6 3 1 1 3 3 3 3 1 3 3 1 1 1 1 1 3 3 3 3 1 1 1 1 3 3 3 3 3 3 3 9 9 3 4 4 4 4 4 4 4 4 4 4 4 4 4 4 3 6
6 3 3 1 1 1 1 1 1 3 3 3 3 3 3 3 3 3 3 3 3 3 3 3 3 3 3 3 3 3 9 9 9 3 3 4 4 4 4 4 4 4 4 4 4 4 4 3 3 6
6 3 3 3 1 3 3 3 3 3 3 9 9 3 3 3 3 3 3 3 3 3 3 3 9 9 9 9 9 9 9 3 3 3 3 3 4 4 4 4 4 4 4 5 4 4 4 4 3 6
6 3 1 3 1 3 1 3 3 3 3 9 9 3 3 3 3 3 3 3 3 3 3 9 9 9 3 3 3 3 3 3 3 3 3 3 4 4 4 4 4 4 4 4 4 4 4 4 3 6
6 3 1 3 1 3 1 1 3 3 3 3 9 9 3 3 3 3 3 3 3 3 9 9 3 3 3 3 3 3 3 3 3 3 3 3 3 4 4 4 4 4 4 4 4 4 4 3 3 6
6 3 1 3 1 3 3 3 3 3 3 3 3 9 9 3 3 3 3 3 3 9 9 3 3 3 3 3 3 3 3 3 3 3 3 3 3 3 4 4 4 4 4 4 4 4 3 3 3 6
6 3 1 3 1 1 1 1 3 3 3 3 3 3 9 3 3 3 3 3 9 9 3 3 3 3 3 3 3 3 3 3 3 3 3 3 3 3 3 3 3 3 3 3 3 3 3 3 3 6
6 1 1 3 1 3 3 1 1 3 3 3 3 3 9 9 3 3 3 9 9 3 3 3 3 3 3 3 3 3 3 3 3 3 3 3 3 3 3 3 3 3 3 3 3 3 3 3 3 6
6 3 3 3 1 3 3 3 1 3 3 3 3 3 3 9 9 3 9 9 3 3 3 3 3 3 3 3 3 3 3 3 3 3 3 3 3 3 3 3 3 3 3 3 3 3 3 3 3 6
6 3 3 3 1 3 1 3 1 3 3 3 3 3 3 3 9 9 9 3 3 3 3 3 3 3 3 3 3 3 3 3 3 3 3 3 3 3 3 3 3 3 3 3 3 3 3 3 3 6
6 3 3 3 1 3 1 3 1 3 3 3 3 3 3 3 3 9 3 3 3 3 3 3 3 3 3 3 3 3 3 3 3 3 3 3 3 3 3 3 3 3 3 3 3 3 3 3 3 6
6 3 3 3 3 3 1 3 1 3 3 3 3 3 3 3 3 9 3 3 3 3 3 3 3 3 3 3 3 3 3 3 3 3 3 3 3 3 3 3 3 3 3 3 3 3 3 3 3 6
6 3 3 3 3 3 1 1 1 3 3 3 3 3 3 3 3 9 9 3 3 3 3 3 3 3 3 3 3 3 3 3 3 3 3 3 3 3 3 3 3 3 3 3 3 3 3 3 3 6
6 3 3 3 3 3 3 3 3 3 3 3 3 3 3 3 3 3 9 3 3 3 3 3 3 3 3 3 3 3 3 3 3 3 3 3 3 3 3 3 3 3 3 3 3 3 3 3 3 6
6 3 3 3 3 3 3 3 3 3 3 3 3 3 3 3 3 3 9 9 3 3 3 3 3 3 3 3 3 3 3 3 3 3 3 3 3 3 3 3 3 3 3 3 3 3 3 3 3 6
6 3 3 3 3 3 3 3 3 3 3 3 3 3 3 3 3 3 3 9 3 3 3 3 3 3 3 3 3 3 3 3 3 3 3 3 3 3 3 3 3 3 3 3 3 3 3 3 3 6
6 3 3 3 3 3 3 3 3 3 3 3 3 3 3 3 3 3 3 9 3 3 3 3 3 3 3 3 3 3 3 3 3 3 3 3 3 3 3 3 3 3 3 3 3 3 3 3 3 6
6 3 3 3 3 3 3 3 3 3 3 3 3 3 3 3 3 3 9 9 9 9 9 9 9 9 9 9 9 9 9 3 3 3 3 3 3 3 3 3 3 3 3 3 3 3 3 3 3 6
6 3 3 3 3 3 3 3 3 3 3 3 3 3 3 3 3 3 3 9 0 9 9 9 9 9 9 9 9 9 3 3 3 3 3 3 3 3 3 3 3 3 3 3 3 3 3 3 3 6
6 3 3 3 3 3 3 3 3 3 3 3 3 3 3 3 3 3 3 3 3 3 3 3 3 3 3 9 9 3 3 3 3 3 3 3 3 3 3 3 3 3 3 3 3 3 3 3 3 6
6 3 3 3 3 3 3 3 3 3 3 3 3 3 3 3 3 3 3 3 3 3 3 3 3 3 3 3 9 9 3 3 3 3 3 3 3 3 3 3 3 3 3 3 3 3 3 3 3 6
6 3 3 3 3 3 3 3 3 3 3 3 3 3 3 3 3 3 3 3 3 3 3 3 3 3 3 3 3 9 9 3 3 3 3 3 3 3 3 3 3 3 3 3 3 3 3 3 3 6
6 3 3 1 3 3 3 3 3 3 3 3 3 3 3 3 3 3 3 3 3 3 3 3 3 3 3 3 3 3 9 9 3 3 3 3 3 3 3 3 3 3 3 3 3 3 3 3 3 6
6 3 3 1 3 3 3 3 3 3 3 3 3 3 3 3 3 3 3 3 3 3 3 3 3 3 3 3 3 3 3 9 9 3 3 3 3 3 3 3 3 3 3 3 3 3 3 3 3 6
6 3 3 1 3 3 3 3 3 3 3 3 3 3 3 3 3 3 3 3 3 1 3 3 3 3 3 3 3 3 3 3 9 9 3 3 3 3 3 3 3 3 3 3 3 3 3 3 3 6
6 3 3 1 3 3 3 3 3 3 3 3 3 3 3 3 3 3 3 3 3 1 3 1 1 1 1 1 1 1 1 1 3 9 9 3 3 3 3 3 3 3 3 3 3 3 3 3 3 6
6 3 3 1 1 1 1 1 1 1 3 3 3 3 3 3 3 3 3 3 3 1 1 1 1 3 3 3 3 3 3 1 3 3 9 9 3 3 3 3 3 3 3 3 3 3 3 3 3 6
6 3 3 3 3 3 3 3 3 1 3 3 3 3 3 3 3 3 3 3 3 3 3 3 1 1 1 1 1 3 3 1 3 3 9 9 3 3 3 3 3 3 3 3 3 3 3 3 3 6
6 3 3 3 3 3 3 1 3 1 3 3 3 3 3 3 3 3 3 3 3 3 3 3 3 3 3 3 1 3 3 1 3 3 9 9 3 3 3 3 3 3 3 3 3 3 3 3 3 6
6 3 1 1 1 1 1 1 3 3 3 3 3 3 3 3 3 3 3 3 3 1 1 1 1 1 1 3 1 3 3 1 3 3 9 9 3 3 3 3 3 3 3 3 3 3 3 3 3 6
6 3 1 3 3 3 3 3 3 1 3 3 3 3 3 3 3 3 3 3 3 3 3 3 3 3 1 3 1 3 3 1 3 3 9 9 3 3 3 3 3 3 3 3 3 3 3 3 3 6
6 3 1 3 3 3 3 1 1 1 3 3 3 3 3 3 3 3 3 3 3 3 3 1 1 1 1 3 1 3 3 1 3 3 3 9 9 3 3 3 3 3 3 3 3 3 3 3 3 6
6 3 1 3 3 3 3 1 3 3 3 3 3 3 3 3 3 3 3 3 3 3 3 1 3 3 3 3 1 3 3 1 1 3 3 9 9 3 3 3 3 3 3 3 3 3 3 3 3 6
6 3 1 3 3 3 3 1 3 3 3 3 3 3 3 3 3 3 3 3 3 3 1 1 3 3 3 3 1 3 3 3 1 1 3 1 3 3 3 3 3 3 3 3 3 3 3 3 3 6
6 3 1 3 3 3 3 1 3 3 3 3 3 3 3 3 3 3 3 1 3 3 1 3 3 3 3 3 1 3 3 3 3 3 3 1 3 3 3 3 3 3 3 3 3 3 3 3 3 6
6 3 1 1 1 1 1 1 3 3 3 3 3 3 3 3 3 3 3 1 1 3 1 1 1 1 1 1 1 3 3 3 1 3 3 1 3 3 3 3 3 3 3 3 3 3 3 3 3 6
6 3 3 3 3 3 3 1 3 3 3 3 3 3 3 3 3 3 3 1 3 3 3 3 3 3 3 3 3 3 3 3 1 3 3 1 1 1 1 1 3 3 3 3 3 3 3 3 3 6
6 3 3 3 3 3 3 1 3 3 1 1 1 1 1 1 1 1 1 1 3 3 3 3 3 3 3 3 3 3 3 3 1 3 3 1 3 3 3 1 3 3 3 3 3 3 3 3 3 6
6 3 3 3 3 3 3 3 3 3 1 3 3 3 3 3 3 3 3 1 3 3 3 3 3 3 3 3 3 3 3 3 1 3 3 1 3 3 3 1 3 3 3 3 3 3 3 3 3 6
6 3 3 3 3 3 3 1 3 3 1 1 1 3 1 1 1 1 3 1 3 3 3 3 3 3 3 3 3 3 3 3 1 1 3 1 3 3 3 1 3 3 3 3 3 3 3 3 3 6
6 3 3 3 3 3 3 1 3 3 3 3 1 3 3 3 3 3 3 1 3 3 3 3 3 3 3 3 3 3 3 3 3 1 1 1 3 3 3 1 3 3 3 3 3 3 3 3 3 6
6 3 3 3 3 3 3 1 3 3 3 3 1 3 3 3 3 3 3 3 3 3 3 3 3 3 3 3 3 3 3 3 3 1 3 3 3 3 3 3 3 3 3 3 3 3 3 3 3 6
6 6 6 6 6 6 6 6 6 6 6 6 6 6 6 6 6 6 6 6 6 6 6 6 6 6 6 6 6 6 6 6 6 6 6 6 6 6 6 6 6 6 6 6 6 6 6 6 6 6