6 7 8 6 6 6 6 6 6 6 6 6 6 6 1 1
6 3 3 3 0 0 0 0 0 0 0 0 0 0 0 1
6 3 3 3 0 0 0 9 9 0 0 0 0 0 0 1
1 3 3 3 0 0 0 0 9 9 9 0 0 0 0 1
1 3 3 0 0 0 0 0 0 0 9 0 0 0 0 1
1 3 0 0 0 0 0 0 0 0 0 4 4 4 0 1
1 3 0 0 0 0 0 0 0 0 0 4 5 4 0 1
1 3 0 2 0 0 0 0 0 0 0 0 4 4 0 1
1 3 2 2 2 0 0 0 0 0 0 0 0 0 0 1
1 3 0 2 0 0 0 0 0 0 0 0 0 0 0 1
1 3 0 0 0 0 0 0 0 0 0 0 0 0 0 1
1 1 1 1 1 1 1 1 1 1 1 1 1 1 1 1