6 6 7 8 6 6 6 6 6 6 6 6 6 6 6 6 6 6 6 6 6 6 6 6 6 6 6 6 6 6 6 6 6 6 6 6 6 6 6 6 6 6 6 6 6 6 6 6 6 6
6 3 3 3 1 3 3 3 1 3 3 3 3 3 3 3 3 3 3 3 3 3 1 3 3 3 1 3 3 3 3 1 3 3 3 3 3 3 3 3 3 3 3 3 3 3 3 3 3 6
6 3 3 3 1 3 1 3 1 3 3 3 1 1 1 1 3 3 1 1 1 3 1 3 3 3 3 3 1 1 3 1 3 3 3 3 3 3 3 3 3 3 3 3 3 3 3 3 3 6
6 3 3 3 1 3 1 3 1 3 3 3 1 3 3 3 3 3 3 3 1 3 1 1 1 3 1 3 3 1 3 1 3 3 3 3 3 3 3 1 3 3 3 3 3 1 1 1 1 6
6 3 3 3 3 3 1 3 1 3 1 1 1 1 3 1 1 1 1 3 1 3 3 3 3 3 1 3 3 1 3 1 3 3 3 3 3 3 3 1 3 3 3 3 3 1 3 3 3 6
6 1 1 1 3 3 1 3 3 3 3 3 3 3 3 1 3 3 3 3 1 3 1 1 1 1 1 3 3 1 3 1 3 3 1 1 1 1 1 1 1 1 1 1 3 1 3 3 3 6
6 3 3 3 3 3 1 3 1 3 3 3 3 3 3 1 1 1 1 3 1 3 3 3 3 3 3 3 3 1 3 1 3 3 1 3 3 3 3 3 3 3 3 3 3 3 3 3 3 6
6 3 3 3 3 3 1 3 1 3 3 3 3 3 3 3 3 3 3 3 1 3 3 3 3 3 3 3 3 3 3 3 3 3 1 3 3 3 3 3 3 3 3 3 3 3 3 3 3 6
6 1 1 1 1 1 1 1 1 1 1 1 1 1 1 1 1 1 1 1 1 1 1 1 1 1 1 1 1 1 1 1 1 1 1 1 1 1 1 1 1 1 1 1 1 1 3 1 1 6
6 3 3 3 1 3 3 3 3 3 3 3 3 3 3 3 3 3 3 3 3 3 3 3 3 3 3 3 3 3 3 3 3 3 3 3 1 1 3 3 3 3 3 3 1 1 3 3 3 6
6 3 1 3 1 3 1 3 3 3 3 3 3 3 3 3 3 3 3 3 3 3 3 3 3 3 3 3 3 3 3 3 3 3 3 3 1 1 3 3 3 3 3 3 1 1 3 3 3 6
6 3 1 3 1 3 1 1 1 3 3 3 3 1 1 1 1 1 1 1 3 3 1 3 3 3 3 3 3 3 3 3 1 1 3 3 1 1 3 3 1 1 3 3 1 1 3 3 3 6
6 3 1 3 1 3 3 3 3 3 3 3 3 1 3 3 3 3 3 1 3 3 1 3 3 3 3 3 3 3 3 3 1 1 3 3 1 1 3 3 1 1 3 3 1 1 3 3 3 6
6 3 1 3 1 3 1 1 3 3 3 3 3 1 3 3 3 3 3 1 3 3 1 3 3 3 3 1 3 3 3 3 1 1 3 3 1 1 3 3 1 1 3 3 1 1 3 3 3 6
6 1 1 3 1 3 3 1 1 3 3 3 3 1 3 3 3 3 3 1 3 3 1 3 3 3 3 1 3 3 3 3 1 1 3 3 1 1 3 3 1 1 3 3 1 1 3 3 3 6
6 3 3 3 1 3 3 3 1 3 3 3 3 1 3 3 3 3 3 1 3 3 1 3 3 3 3 1 3 3 3 3 1 1 3 3 1 1 3 3 1 1 3 3 1 1 3 3 3 6
6 3 3 3 1 3 1 3 1 3 3 3 3 1 3 3 3 3 3 1 3 3 1 1 1 1 1 1 3 3 3 3 1 1 3 3 1 1 3 3 1 1 3 3 1 1 3 3 3 6
6 3 3 3 1 3 1 3 1 3 3 3 3 3 3 3 3 3 3 3 3 3 3 3 3 3 3 3 3 3 3 3 1 1 3 3 3 3 3 3 1 1 3 3 3 3 3 3 3 6
6 3 3 3 3 3 1 3 1 3 3 3 3 3 3 3 3 3 3 3 3 3 3 3 3 3 3 3 3 3 3 3 1 1 3 3 3 3 3 3 1 1 3 3 3 3 3 3 3 6
6 1 1 3 1 1 1 1 1 1 1 1 1 1 1 1 1 1 1 1 1 1 1 1 1 1 1 1 1 1 1 1 1 1 1 1 1 1 1 1 1 1 1 1 1 1 1 1 1 6
6 1 1 3 3 3 3 3 3 3 3 3 3 3 1 1 1 1 1 1 1 1 1 1 1 1 1 1 1 1 1 1 1 1 1 1 1 1 1 1 1 1 1 1 1 1 1 1 1 6
6 1 1 3 3 3 3 3 3 4 4 4 4 3 1 1 3 3 3 3 3 3 3 3 3 3 3 3 3 3 3 3 3 3 3 3 3 3 3 3 3 3 3 3 3 3 3 3 3 6
6 1 1 3 3 3 3 3 4 4 4 4 4 3 1 1 3 3 3 3 3 3 3 3 3 3 3 3 3 3 3 3 3 3 3 3 3 3 3 3 3 3 3 3 3 3 3 3 3 6
6 1 1 3 3 3 3 4 4 5 5 4 4 3 1 1 3 3 3 3 3 3 3 3 3 3 3 3 3 3 3 3 3 3 3 3 3 3 3 3 3 3 3 3 3 3 3 3 3 6
6 1 1 3 3 1 4 4 4 4 4 4 3 3 1 1 3 3 3 3 3 3 3 3 3 3 3 3 3 3 3 3 3 3 3 3 3 3 3 3 3 3 3 3 3 3 3 3 3 6
6 1 1 3 3 1 4 4 4 4 4 3 3 3 1 1 3 3 3 3 0 3 3 3 3 3 3 3 3 3 3 3 3 3 3 3 3 3 3 3 3 3 3 3 3 3 3 3 3 6
6 1 1 3 3 1 1 3 3 3 3 3 3 3 1 1 3 3 3 3 3 3 3 3 3 3 3 3 3 3 3 3 3 3 3 3 3 3 3 3 11 3 3 3 3 3 3 3 3 6
6 1 1 3 3 1 1 3 3 3 3 3 3 3 1 1 3 3 3 3 3 3 3 3 10 10 10 3 3 3 3 3 3 3 3 3 3 3 3 3 3 11 3 3 3 3 3 3 3 6
6 1 1 3 3 1 1 3 3 1 1 3 3 3 1 1 3 3 3 3 3 3 3 3 3 3 3 3 3 3 3 3 3 3 3 3 3 3 3 3 11 3 3 3 3 3 3 3 3 6
6 1 1 3 3 1 1 3 3 1 1 3 3 3 1 1 3 3 3 3 3 3 3 3 3 3 3 3 3 3 3 3 3 3 3 3 3 3 3 3 11 3 3 3 3 3 3 3 3 6
6 1 1 3 3 1 1 3 3 1 1 3 3 3 1 1 3 3 3 3 3 3 3 3 3 3 3 3 3 3 3 3 3 3 3 3 3 3 3 3 3 3 3 3 3 3 3 3 3 6
6 1 1 3 3 3 3 3 3 1 1 3 3 3 1 1 3 3 3 3 3 3 3 3 3 3 3 3 3 3 3 3 3 3 3 3 3 3 3 3 3 3 3 3 3 3 3 3 3 6
6 1 1 3 3 3 3 3 3 1 1 3 3 3 1 1 3 3 3 3 3 3 3 3 3 3 3 3 3 3 3 3 3 3 11 3 3 3 3 3 3 3 3 3 3 3 3 3 3 6
6 1 1 3 3 1 1 3 3 1 1 3 3 3 1 1 3 3 3 3 3 3 3 3 3 3 3 3 3 3 3 3 3 3 11 3 3 3 3 3 3 3 3 3 3 3 3 3 3 6
6 1 1 1 3 1 1 3 3 1 1 3 3 3 1 1 3 3 3 3 3 3 3 3 3 3 3 3 3 3 3 3 3 3 3 3 3 3 3 3 3 3 3 3 3 3 3 3 3 6
6 1 1 3 3 1 1 3 3 1 1 3 3 3 1 1 3 3 3 3 3 3 3 3 11 11 3 3 3 3 3 3 3 3 3 3 3 3 3 3 3 3 3 3 3 3 3 3 3 6
6 1 1 3 3 1 1 3 3 1 1 3 3 3 1 1 3 10 3 3 3 3 3 3 11 11 3 3 3 3 3 3 3 3 3 3 3 3 3 3 3 3 3 3 3 3 3 3 3 6
6 1 1 3 3 1 1 3 3 1 1 3 3 3 1 1 3 3 3 3 3 3 3 3 11 11 3 3 3 3 3 3 3 3 3 3 10 10 10 10 3 3 3 3 3 3 3 3 3 6
6 1 1 3 1 1 1 3 3 3 3 3 3 3 1 1 3 3 3 3 3 3 3 3 11 11 3 3 3 3 3 3 3 3 3 3 3 3 3 3 3 3 3 3 3 3 3 3 3 6
6 1 1 3 3 1 1 3 3 3 3 3 3 3 1 1 3 3 3 3 3 3 3 3 11 11 3 3 3 3 3 3 3 3 3 3 3 3 3 3 3 3 3 3 3 3 3 3 3 6
6 1 1 3 3 1 1 3 3 1 1 3 3 3 1 1 3 3 3 3 3 3 3 3 11 11 3 3 3 3 3 3 3 3 3 3 3 3 3 3 3 3 3 3 3 3 3 3 3 6
6 1 1 3 3 1 1 3 3 1 1 3 3 3 1 1 3 3 3 3 3 3 3 3 3 3 3 3 3 3 3 3 3 3 3 3 3 3 3 3 3 3 3 3 3 3 3 3 3 6
6 1 1 1 3 1 1 3 3 1 1 3 3 3 1 1 3 3 3 3 3 3 3 3 3 3 3 3 3 3 3 3 3 3 3 3 3 3 3 3 3 3 3 3 3 3 3 3 3 6
6 1 1 3 3 1 1 3 3 1 1 3 3 3 1 1 3 3 3 3 3 3 3 3 3 3 3 3 3 3 3 3 3 3 3 3 3 3 3 3 3 3 3 3 3 3 3 3 3 6
6 1 1 3 3 1 1 3 3 1 1 3 3 3 1 1 3 3 3 3 3 3 3 3 3 3 3 3 3 3 3 3 3 10 3 3 3 3 3 3 3 3 3 3 1 1 1 9 1 6
6 1 1 3 3 1 1 3 3 1 1 3 3 3 0 0 3 3 3 3 3 3 3 3 3 3 3 3 3 3 3 3 3 10 3 3 3 3 3 3 3 3 3 3 1 1 1 9 1 6
6 1 1 3 1 1 1 3 3 1 1 3 3 3 1 1 3 3 3 3 3 3 3 3 3 3 3 3 3 3 3 3 3 10 3 3 3 3 3 3 3 3 3 3 1 1 9 9 9 6
6 1 1 3 3 1 1 3 3 1 1 3 3 3 1 1 3 3 3 3 3 3 3 3 3 3 3 3 3 3 3 3 3 10 3 3 3 3 3 3 3 3 3 3 1 1 9 9 9 6
6 1 1 3 3 1 1 3 3 1 1 3 3 3 1 1 3 3 3 3 3 3 3 3 3 3 3 3 3 3 3 3 3 3 3 3 3 3 3 3 3 3 3 3 1 1 9 9 9 6
6 6 6 6 6 6 6 6 6 6 6 6 6 6 6 6 6 6 6 6 6 6 6 6 6 6 6 6 6 6 6 6 6 6 6 6 6 6 6 6 6 6 6 6 6 6 6 6 6 6