6 6 6 6 6 6 6 6 6 6 6 6 6 6 6 6 6 6 6 6 6 6 6 6 6 6 6 6 6 6 6 6 6 6 6 6 6 6 6 6 6 6 6 6 7 8 6 6 6 6
6 3 3 3 1 3 3 3 1 3 3 3 3 3 3 3 3 3 3 3 3 3 1 3 3 3 1 3 3 3 3 1 3 3 3 1 9 9 9 1 9 9 9 1 9 9 9 9 9 6
6 3 3 3 1 3 1 3 1 3 3 3 1 1 1 1 3 3 1 1 1 3 1 3 3 3 3 3 1 1 3 1 3 3 3 1 9 1 9 1 9 1 9 1 9 9 9 9 9 6
6 3 3 3 1 3 1 3 1 3 3 3 1 3 3 3 3 3 3 3 1 3 1 1 1 3 1 3 3 1 3 1 3 3 3 1 9 1 9 1 9 1 9 1 9 9 9 1 9 6
6 3 3 3 3 3 1 3 1 3 1 1 1 1 3 1 1 1 1 3 1 3 3 3 3 3 1 3 3 1 3 1 3 3 3 1 9 1 9 1 9 1 9 1 9 1 9 1 9 6
6 1 1 1 1 3 1 3 3 3 3 3 3 3 3 1 3 3 3 3 1 3 1 1 1 1 1 3 3 1 3 1 3 1 3 1 9 1 9 1 9 1 9 1 9 1 9 1 9 6
6 3 3 3 3 3 1 3 1 3 3 3 3 3 3 1 1 1 1 3 1 3 3 3 3 3 3 3 3 1 3 1 3 1 3 1 9 1 9 1 9 1 9 1 9 1 9 1 9 6
6 3 1 1 3 3 1 3 1 3 3 1 1 1 1 1 3 3 1 3 1 1 1 1 1 3 3 3 3 3 3 3 3 1 3 1 9 1 9 1 9 1 9 1 9 1 9 1 9 6
6 3 3 1 1 1 1 1 1 3 3 3 3 3 3 3 3 3 1 3 3 3 3 3 1 3 3 1 3 3 1 1 1 1 3 1 9 1 9 1 9 1 9 1 9 1 9 1 9 6
6 3 3 3 1 3 3 3 3 3 3 1 3 1 3 3 3 3 1 3 3 1 3 3 1 3 3 1 3 3 3 3 3 3 3 1 9 1 9 1 9 1 9 1 9 1 9 1 9 6
6 3 1 3 1 3 1 3 3 3 3 1 3 1 1 3 3 3 1 3 3 1 3 3 3 3 3 1 3 3 3 3 3 3 3 1 9 1 9 9 9 9 9 9 9 9 9 1 9 6
6 3 1 3 1 3 1 1 3 3 3 1 3 3 1 1 3 3 3 3 3 1 3 3 1 1 1 1 3 3 3 1 1 1 1 1 9 1 1 1 1 9 1 1 1 1 1 1 1 6
6 3 1 3 1 3 3 3 3 3 3 1 3 3 3 1 3 3 3 3 3 1 1 1 1 3 3 3 3 3 3 1 9 9 9 9 9 9 9 9 9 9 9 9 9 9 9 9 1 6
6 3 1 3 3 3 3 3 3 3 3 1 3 3 3 3 3 3 3 3 3 3 3 3 3 3 3 3 3 3 3 1 9 9 9 9 9 9 9 9 9 9 9 9 9 9 9 9 1 6
6 1 1 3 3 3 3 3 1 3 3 1 1 1 1 1 1 1 1 1 1 1 1 1 1 1 1 1 3 3 1 1 9 9 9 9 9 9 9 9 9 9 9 9 9 9 9 9 1 6
6 3 3 3 3 3 3 3 1 3 9 9 9 9 9 1 1 9 9 9 9 9 9 9 9 9 9 9 3 3 1 2 9 2 2 2 2 2 2 2 2 2 2 2 2 2 2 2 1 6
6 3 3 3 3 3 1 3 1 3 9 9 9 9 9 1 9 9 9 9 9 9 9 9 9 9 1 3 3 1 1 2 9 2 2 2 2 2 2 2 2 2 2 2 2 2 2 2 1 6
6 1 1 1 1 1 1 1 1 1 9 1 1 1 1 1 1 1 1 1 9 1 1 1 1 1 1 1 1 1 9 9 9 9 9 9 9 9 9 9 9 9 9 9 9 9 9 9 1 6
6 3 3 3 3 3 3 3 3 1 9 1 3 3 3 3 3 3 3 1 9 1 3 3 3 3 4 4 1 1 9 9 9 9 9 9 9 9 9 9 9 9 9 9 9 9 9 9 1 6
6 3 3 3 1 3 1 3 3 1 9 1 3 3 1 1 1 1 1 1 9 1 3 4 4 4 4 4 1 1 2 2 2 2 2 2 2 2 2 2 2 2 2 2 2 2 9 9 1 6
6 3 1 3 1 3 1 1 1 1 9 1 3 3 1 3 3 3 3 1 9 1 3 4 5 5 4 4 1 1 2 2 2 2 2 2 2 2 2 2 2 2 2 2 2 2 9 9 1 6
6 3 1 3 1 3 3 3 3 1 9 1 3 1 1 3 4 3 3 1 9 1 4 4 4 4 4 4 1 1 9 9 9 9 9 9 9 9 9 9 9 9 9 9 9 9 9 9 1 6
6 3 1 3 1 1 1 1 3 1 9 1 3 3 1 4 4 4 4 1 9 1 1 1 1 1 1 3 1 1 9 9 9 9 9 9 9 9 9 9 9 9 9 9 9 9 9 9 1 6
6 3 1 3 3 3 3 3 3 1 9 1 3 3 1 4 4 4 4 1 9 1 4 4 4 4 1 3 1 1 9 9 2 2 2 2 2 2 2 2 2 2 2 2 2 2 2 2 1 6
6 3 1 3 3 3 3 3 3 1 9 1 3 3 1 3 4 5 4 1 9 1 4 4 4 4 1 3 1 1 9 9 2 2 2 2 2 2 2 2 2 2 2 2 2 2 2 2 1 6
6 1 1 3 1 1 1 1 1 1 9 1 3 3 1 3 4 5 4 1 0 1 4 4 4 4 1 3 1 1 9 9 9 9 9 9 9 9 9 9 9 9 9 9 9 9 9 9 1 6
6 9 9 9 9 9 9 9 9 9 9 1 3 3 1 3 4 4 4 1 9 1 4 4 4 4 1 3 1 1 9 9 9 9 9 9 9 9 9 9 9 9 9 9 9 9 9 9 1 6
6 9 9 1 1 1 1 1 1 1 9 1 3 3 1 3 3 4 4 1 9 1 4 4 4 4 1 3 1 1 2 2 2 2 2 2 2 2 2 2 2 2 2 2 2 2 9 9 1 6
6 9 9 9 3 3 3 3 3 3 3 1 3 3 1 3 3 3 4 1 9 1 3 4 4 4 1 3 1 1 2 2 2 2 2 2 2 2 2 2 2 2 2 2 2 2 9 9 1 6
6 9 9 1 3 3 3 3 3 3 3 1 3 3 1 1 1 1 1 1 9 1 1 1 4 4 1 3 1 1 9 9 9 9 9 9 9 9 9 9 9 9 9 9 9 9 9 9 1 6
6 9 9 1 3 3 3 3 3 3 3 1 1 3 3 3 3 3 3 1 9 1 1 1 1 1 1 3 1 1 9 9 9 9 9 9 9 9 9 9 9 9 9 9 9 9 9 9 1 6
6 9 9 1 3 3 3 3 3 3 3 1 1 1 1 1 1 3 3 1 9 1 3 3 3 3 3 3 1 1 9 9 9 9 2 2 2 2 2 2 2 2 2 2 2 2 2 2 1 6
6 9 9 1 3 3 3 3 3 3 3 1 3 3 3 3 1 3 3 1 9 1 3 1 1 1 1 1 1 1 1 1 9 9 2 2 2 2 2 2 2 2 2 2 2 2 2 2 1 6
6 9 9 1 1 1 1 1 1 1 1 1 3 3 3 3 1 3 3 1 1 1 1 1 1 3 3 3 3 3 1 1 9 9 9 9 9 9 9 9 9 9 9 9 9 9 9 9 1 6
6 9 9 9 9 9 9 9 3 1 3 3 3 3 3 3 3 3 3 3 3 3 3 3 1 1 1 1 1 3 1 1 9 9 9 9 9 9 9 9 9 9 9 9 9 9 9 9 1 6
6 9 9 9 9 9 9 1 3 1 3 3 3 3 3 3 3 3 3 3 3 3 3 3 3 3 3 3 1 3 1 1 2 2 2 2 2 2 2 2 2 2 2 2 2 2 9 9 1 6
6 9 1 1 1 1 1 1 3 3 3 3 3 3 3 3 3 3 3 3 3 1 1 1 1 1 1 3 1 3 1 1 2 2 2 2 2 2 2 2 2 2 2 2 2 2 9 9 1 6
6 9 1 3 3 3 3 3 3 1 3 3 3 3 3 3 3 3 3 3 3 3 3 3 3 3 1 3 1 3 1 1 9 9 9 9 9 9 9 9 9 9 9 9 9 9 9 9 1 6
6 9 1 3 1 3 3 1 1 1 3 3 3 3 3 3 3 3 3 3 3 3 3 1 1 1 1 3 1 3 1 1 9 9 9 9 9 9 9 9 9 9 9 9 9 9 9 9 1 6
6 9 1 3 1 3 3 1 3 3 3 3 3 3 3 3 3 3 3 3 3 3 3 1 3 3 3 3 1 3 1 1 9 9 2 2 2 2 2 2 2 2 2 2 2 2 2 2 1 6
6 9 1 3 1 3 3 1 3 3 3 3 3 3 3 3 3 3 3 3 3 3 1 1 3 3 3 3 1 3 1 1 9 9 2 2 2 2 2 2 2 2 2 2 2 2 2 2 1 6
6 1 1 3 3 3 3 1 3 3 3 3 3 3 3 3 3 3 3 1 3 3 1 3 3 3 3 3 1 3 1 1 9 9 9 9 9 9 9 9 9 9 9 9 9 9 9 9 1 6
6 3 1 1 1 1 1 1 3 3 3 3 3 3 3 3 3 3 3 1 1 3 1 1 1 1 1 1 1 3 1 1 9 9 9 9 9 9 9 9 9 9 9 9 9 9 9 9 1 6
6 3 3 3 3 3 3 1 3 3 3 3 3 3 3 3 3 3 3 1 3 3 3 3 3 3 3 3 3 3 1 1 2 2 2 2 2 2 2 2 2 2 2 2 2 2 9 9 1 6
6 3 3 3 3 3 3 1 3 3 1 1 1 1 1 1 1 1 1 1 3 3 3 3 3 3 3 3 3 3 1 1 2 2 2 2 2 2 2 2 2 2 2 2 2 2 9 9 1 6
6 3 3 3 3 3 3 3 3 3 3 3 3 3 3 3 3 3 3 1 3 3 3 3 3 3 3 3 3 3 1 1 9 9 9 9 9 9 9 9 9 9 9 9 9 9 9 9 1 6
6 3 3 3 3 3 3 1 3 3 1 1 1 3 1 1 1 1 3 1 3 3 3 3 3 3 3 3 3 3 1 1 9 1 9 9 9 9 9 9 9 9 9 9 9 9 9 9 1 6
6 3 3 3 3 3 3 1 3 3 3 3 1 3 3 3 3 3 3 1 3 3 3 3 3 3 3 3 3 3 1 1 3 1 1 1 1 1 1 1 1 1 1 1 1 1 1 1 1 6
6 3 3 3 3 3 3 1 3 3 3 3 1 3 3 3 3 3 3 3 3 3 3 3 3 3 3 3 3 3 3 3 3 1 3 3 3 3 3 3 3 3 3 3 3 3 3 3 3 6
6 6 6 6 6 6 6 6 6 6 6 6 6 6 6 6 6 6 6 6 6 6 6 6 6 6 6 6 6 6 6 6 6 6 6 6 6 6 6 6 6 6 6 7 8 6 6 6 6 6